1000000111
1011111011
1011110011
1011000111
1011001111
1011100011
1011111001
1011111101
1000000001
1111111111
