1111111111
1000000001
1011111101
1011001101
1010000101
1010000101
1001001101
1101011101
1100011001
1111111011
