1111011111
1100011101
1101100001
1001110101
1010000001
1010111101
1010111101
1010000101
1000110001
1111111111
