1111111111
1111111111
1100000001
1101111101
1101000101
1101110101
1100000101
1111111101
0000000001
1111111111
