1100011111
1100011111
1111000111
1111000111
1111000111
1100011111
1100011111
1100000011
1111100011
1111100011
