1111011111
1000000001
1000000001
1000100001
1001010001
1010001001
1000000001
1000000001
1000000001
1111011111
