1111011101
1111011101
1100000101
1100000101
0000000000
1100000101
1100000101
0011111101
1000000001
1011111101
